1111111111111111111111111111111111111111
1                                      1
1  p                                   1
1           c                          1
1                                      1
1                                      1
1     z         r   g                  1
1                                      1
1                                      1
1                                      1
1       z                              1
1                                      1
1                                      1
1                                      1
1                                      1
1                                      1
1                                      1
1         g                            1
1                                      1
1111111111111111111111111111111111111111