1111111111111111111111111111111111111111
1         g                            1
1  p                                   1
1            z               cz        1
1             g                        1
111111111111111                        1
1     z      11  r   r      111111111111
1            11            1111111111111
1            11           11111   z   11
1            11           111111     111
1       z                  111111   1111
1                           11111   1111
1       r         r                    1
1                                      1
1        r                             1
1                            cz        1
1                                      1
1         r                            1
1                                      1
1111111111111111111111111111111111111111