1111111111111111111111111111111111111111
1                                z     1
1      cz                       zzz    1
1                    g g     r   z     1
1                              r       1
111                                  111
111                                  111
111                 11111            111
111       z        1     1     z     111
111               1   p   1          111
111       h       1       1       h  111
111          h    1       1   h      111
111                1     1           111
111                 1   1            111
111                                  111
1                     z                1
1      cz           r z r              1
1                     z                1
1                     r                1
1111111111111111111111111111111111111111