111111111110111111111111
111100000000000000000001
100000000000000000000001
100000000000000000000001
100010010000000000000001
100000000000000000000001
100000000000000000000001
111111111111111111111111