111111111110111111111111
111100000000000000000001
1000000g0000000000000001
100000000000c00000000001
100010010000000000000001
1000000000000000r0000001
10000000000000000000g001
111111111111111111111111